0 0 1 0 0 0 1 0 0 0 1 0 0 0 1 2 
3 3 3 3 3 3 3 3 3 3 3 3 3 3 3 4 
5 5 5 5 5 5 5 5 5 5 5 5 5 5 5 6 
5 5 5 5 5 7 5 5 5 5 5 5 5 5 5 6 
5 5 5 5 5 8 5 5 5 5 5 5 5 5 5 6 
5 5 5 7 7 7 5 5 5 5 5 7 5 5 5 6 
5 5 5 9 10 11 5 5 5 5 5 8 5 5 5 6 
5 7 5 5 5 5 5 5 5 5 5 5 5 5 5 6 
5 8 5 5 5 5 5 5 5 5 5 5 5 5 5 6 
5 5 5 5 5 5 5 5 5 5 5 5 5 5 5 6 
5 5 5 5 5 5 5 5 5 5 5 5 5 5 5 6 
12 12 12 12 12 12 12 12 12 12 12 12 12 12 12 13 
14 14 14 14 14 14 14 14 14 14 14 14 14 14 14 15 
16 16 16 16 16 16 16 16 16 16 16 16 16 16 16 16 
16 16 16 16 16 16 16 16 16 16 16 16 16 16 16 16 
16 16 16 16 16 16 16 16 16 16 16 16 16 16 16 16 