0 0 0 0 0 0 0 0 0 0 0 0 0 0 0 0 0 0 0 0 0 0 0 0 0 0 0 0 0 0 0 0 0 0 0 0 0 0 0 0 0 0 0 0 0 0 0 0 0 0 0 0 0 0 0 0 0 0 0 0 0 0 0 0 0 0 0 0 0 0 0 0 0 0 0 0 0 0 0 0 0 0 0 0 0 0 0 0 0 0 0 0 0 0 0 0 0 0 0 0 0 0 0 0 0 0 0 0 0 0 0 0 0 0 0 0 0 0 0 0 0 0 0 0 0 0 0 0 
0 0 0 0 0 0 0 0 0 0 0 0 0 0 0 0 0 0 0 0 0 0 0 0 0 0 0 0 0 0 0 0 0 0 0 0 0 0 0 0 0 0 0 0 0 0 0 0 0 0 0 0 0 0 0 0 0 0 0 0 0 0 0 0 0 0 0 0 0 0 0 0 0 0 0 0 0 0 0 0 0 0 0 0 0 0 0 0 0 0 0 0 0 0 0 0 0 0 0 0 0 0 0 0 0 0 0 0 0 0 0 0 0 0 0 0 0 0 0 0 0 0 0 0 0 0 0 0 
0 0 0 0 0 0 1 0 1 0 0 0 0 0 0 0 0 0 0 0 0 0 1 0 1 0 0 0 0 0 0 0 0 0 0 0 0 0 1 0 1 0 0 0 0 0 0 0 0 0 0 0 0 0 1 0 1 0 0 0 0 0 0 0 0 0 0 0 0 0 1 0 1 0 0 0 0 0 0 0 0 0 0 0 0 0 1 0 1 0 0 0 0 0 0 0 0 0 0 0 0 0 1 0 1 0 0 0 0 0 0 0 0 0 0 0 0 0 0 0 0 0 0 0 0 0 0 0 
0 0 0 0 0 0 2 3 3 0 0 0 0 0 0 0 0 0 0 0 0 0 2 3 3 0 0 0 0 0 0 0 0 0 0 0 0 0 2 3 3 0 0 0 0 0 0 0 0 0 0 0 0 0 2 3 3 0 0 0 0 0 0 0 0 0 0 0 0 0 2 3 3 0 0 0 0 0 0 0 0 0 0 0 0 0 2 3 3 0 0 0 0 0 0 0 0 0 0 0 0 0 2 3 3 0 0 0 0 0 0 0 0 0 0 0 0 0 0 0 0 0 0 0 0 0 0 0 
0 0 0 0 0 0 4 5 5 0 0 0 0 0 0 0 0 0 0 0 0 0 4 5 5 0 0 0 0 0 0 0 0 0 0 0 0 0 4 5 5 0 0 0 0 0 0 0 0 0 0 0 0 0 4 5 5 0 0 0 0 0 0 0 0 0 0 0 0 0 4 5 5 0 0 0 0 0 0 0 0 0 0 0 0 0 4 5 5 0 0 0 0 0 0 0 0 0 0 0 0 0 4 5 5 0 0 0 0 0 0 0 0 0 0 0 0 0 0 0 0 0 0 0 0 0 0 0 
0 0 0 0 0 0 4 5 5 0 0 0 0 0 0 0 0 0 0 0 0 0 4 5 5 0 0 0 0 0 0 0 0 0 0 0 0 0 4 5 5 0 0 0 0 0 0 0 0 0 0 0 0 0 4 5 5 0 0 0 0 0 0 0 0 0 0 0 0 0 4 5 5 0 0 0 0 0 0 0 0 0 0 0 0 0 4 5 5 0 0 0 0 0 0 0 0 0 0 0 0 0 4 5 5 0 0 0 0 0 0 0 0 0 0 0 0 0 0 0 0 0 0 0 0 0 0 0 
0 0 0 0 1 0 4 5 5 0 0 0 0 0 0 0 0 0 0 0 1 0 4 5 5 0 0 0 0 0 0 0 0 0 0 0 1 0 4 5 5 0 0 0 0 0 0 0 0 0 0 0 1 0 4 5 5 0 0 0 0 0 0 0 0 0 0 0 1 0 4 5 5 0 0 0 0 0 0 0 0 0 0 0 1 0 4 5 5 0 0 0 0 0 0 0 0 0 0 0 1 0 4 5 5 0 0 0 0 0 0 0 0 0 0 0 0 0 0 0 0 0 0 0 0 0 0 0 
0 0 0 0 6 7 7 5 5 0 0 0 1 0 0 0 0 0 0 0 6 7 7 5 5 0 0 0 1 0 0 0 0 0 0 0 6 7 7 5 5 0 0 0 1 0 0 0 0 0 0 0 6 7 7 5 5 0 0 0 1 0 0 0 0 0 0 0 6 7 7 5 5 0 0 0 1 0 0 0 0 0 0 0 6 7 7 5 5 0 0 0 1 0 0 0 0 0 0 0 6 7 7 5 5 0 0 0 1 0 0 0 0 0 0 0 0 0 0 0 0 0 0 0 0 0 0 0 
0 0 0 0 8 9 9 5 5 0 0 0 2 3 0 0 0 0 0 0 8 9 9 5 5 0 0 0 2 3 0 0 0 0 0 0 8 9 9 5 5 0 0 0 2 3 0 0 0 0 0 0 8 9 9 5 5 0 0 0 2 3 0 0 0 0 0 0 8 9 9 5 5 0 0 0 2 3 0 0 0 0 0 0 8 9 9 5 5 0 0 0 2 3 0 0 0 0 0 0 8 9 9 5 5 0 0 0 2 3 0 0 0 0 0 0 0 0 0 0 0 0 0 0 0 0 0 0 
0 0 0 0 8 9 9 5 5 1 0 0 4 5 1 0 0 0 0 0 8 9 9 5 5 1 0 0 4 5 1 0 0 0 0 0 8 9 9 5 5 1 0 0 4 5 1 0 0 0 0 0 8 9 9 5 5 1 0 0 4 5 1 0 0 0 0 0 8 9 9 5 5 1 0 0 4 5 1 0 0 0 0 0 8 9 9 5 5 1 0 0 4 5 1 0 0 0 0 0 8 9 9 5 5 1 0 0 4 5 1 0 0 0 0 0 0 0 0 0 0 0 0 0 0 0 0 0 
0 0 0 0 8 9 9 5 6 7 0 1 4 6 7 0 0 0 0 0 8 9 9 5 6 7 0 1 4 6 7 0 0 0 0 0 8 9 9 5 6 7 0 1 4 6 7 0 0 0 0 0 8 9 9 5 6 7 0 1 4 6 7 0 0 0 0 0 8 9 9 5 6 7 0 1 4 6 7 0 0 0 0 0 8 9 9 5 6 7 0 1 4 6 7 0 0 0 0 0 8 9 9 5 6 7 0 1 4 6 7 0 0 0 0 0 0 0 0 0 0 0 0 0 0 0 0 0 
0 0 0 0 8 9 9 5 8 9 0 2 4 8 9 0 0 0 0 0 8 9 9 5 8 9 0 2 4 8 9 0 0 0 0 0 8 9 9 5 8 9 0 2 4 8 9 0 0 0 0 0 8 9 9 5 8 9 0 2 4 8 9 0 0 0 0 0 8 9 9 5 8 9 0 2 4 8 9 0 0 0 0 0 8 9 9 5 8 9 0 2 4 8 9 0 0 0 0 0 8 9 9 5 8 9 0 2 4 8 9 0 0 0 0 0 0 0 0 0 0 0 0 0 0 0 0 0 
0 0 10 11 11 11 11 11 11 11 11 11 11 11 11 12 0 0 10 11 11 11 11 11 11 11 11 11 11 11 11 12 0 0 10 11 11 11 11 11 11 11 11 11 11 11 11 12 0 0 10 11 11 11 11 11 11 11 11 11 11 11 11 12 0 0 10 11 11 11 11 11 11 11 11 11 11 11 11 12 0 0 10 11 11 11 11 11 11 11 11 11 11 11 11 12 0 0 10 11 11 11 11 11 11 11 11 11 11 11 11 12 0 0 0 0 0 0 0 0 0 0 0 0 0 0 0 0 
0 0 13 14 14 14 14 14 14 14 14 14 14 14 14 14 0 0 13 14 14 14 14 14 14 14 14 14 14 14 14 14 0 0 13 14 14 14 14 14 14 14 14 14 14 14 14 14 0 0 13 14 14 14 14 14 14 14 14 14 14 14 14 14 0 0 13 14 14 14 14 14 14 14 14 14 14 14 14 14 0 0 13 14 14 14 14 14 14 14 14 14 14 14 14 14 0 0 13 14 14 14 14 14 14 14 14 14 14 14 14 14 0 0 0 0 0 0 0 0 0 0 0 0 0 0 0 0 
0 0 13 15 15 15 15 15 15 15 15 15 15 15 15 15 0 0 13 15 15 15 15 15 15 15 15 15 15 15 15 15 0 0 13 15 15 15 15 15 15 15 15 15 15 15 15 15 0 0 13 15 15 15 15 15 15 15 15 15 15 15 15 15 0 0 13 15 15 15 15 15 15 15 15 15 15 15 15 15 0 0 13 15 15 15 15 15 15 15 15 15 15 15 15 15 0 0 13 15 15 15 15 15 15 15 15 15 15 15 15 15 0 0 0 0 0 0 0 0 0 0 0 0 0 0 0 0 
0 0 13 14 14 14 14 14 14 14 14 14 14 14 14 14 0 0 13 16 16 16 16 16 16 16 16 16 16 16 16 16 0 0 13 17 17 17 17 17 17 17 17 17 17 17 17 17 0 0 13 17 17 17 17 17 17 17 17 17 17 17 17 17 0 0 13 16 16 16 16 16 16 16 16 16 16 16 16 16 0 0 13 14 14 14 14 14 14 14 14 14 14 14 14 14 0 0 13 16 16 16 16 16 16 16 16 16 16 16 16 16 0 0 1 1 0 0 0 0 0 0 0 0 1 1 0 0 
0 0 13 15 18 15 18 15 18 15 15 19 20 19 20 15 0 0 13 21 21 19 20 21 19 20 21 19 20 21 18 22 0 0 13 23 23 18 23 23 23 23 18 23 18 23 18 23 0 0 13 23 23 18 23 23 23 23 18 23 18 23 18 23 0 0 13 21 21 19 20 21 19 20 21 19 20 21 18 22 0 0 13 15 18 15 18 15 18 15 15 19 20 19 20 15 0 0 13 21 21 19 20 21 19 20 21 19 20 21 18 22 0 0 6 7 0 0 0 1 0 0 0 2 6 7 0 0 
0 0 13 15 24 15 25 15 25 15 15 26 27 26 27 15 0 0 13 21 21 28 29 21 28 29 21 28 29 21 30 22 0 1 13 23 23 30 23 31 12 23 30 23 30 23 30 23 0 1 13 23 23 30 23 31 12 23 30 23 30 23 30 23 0 0 13 21 21 28 29 21 28 29 21 28 29 21 30 22 0 0 13 15 24 15 25 15 25 15 15 26 27 26 27 15 0 0 13 21 21 28 29 21 28 29 21 28 29 21 30 22 0 0 8 9 0 0 1 2 3 1 0 4 8 9 1 0 
0 0 13 15 30 15 30 15 30 15 15 28 29 28 29 15 0 0 13 21 21 16 16 21 16 16 24 16 16 21 16 22 0 6 32 23 23 17 23 17 17 23 17 23 17 23 17 23 0 6 32 23 23 17 23 17 17 23 17 23 17 23 17 23 0 0 13 21 21 16 16 21 16 16 24 16 16 21 16 22 0 0 13 15 30 15 30 15 30 15 15 28 29 28 29 15 0 0 13 21 21 16 16 21 16 16 24 16 16 21 16 22 0 0 8 9 0 0 6 7 5 6 0 4 2 3 3 0 
0 0 32 31 11 12 14 15 14 15 15 14 14 14 14 15 1 1 32 33 33 33 33 33 33 33 33 33 33 33 33 33 0 8 34 33 33 33 33 33 33 33 33 33 33 33 33 33 0 8 34 33 33 33 33 33 33 33 33 33 33 33 33 33 1 1 32 33 33 33 33 33 33 33 33 33 33 33 33 33 0 0 32 31 11 12 14 15 14 15 15 14 14 14 14 15 1 1 32 33 33 33 33 33 33 33 33 33 33 33 33 33 35 35 35 35 35 35 35 35 35 35 35 35 35 35 35 35 
0 0 34 33 33 33 33 33 33 33 33 33 33 33 33 33 2 3 34 16 16 16 36 37 38 16 16 16 16 16 16 16 0 8 34 17 24 17 17 17 17 17 17 17 17 17 17 17 0 8 34 17 24 17 17 17 17 17 17 17 17 17 17 17 2 3 34 16 16 16 36 37 38 16 16 16 16 16 16 16 0 0 34 33 33 33 33 33 33 33 33 33 33 33 33 33 2 3 34 16 16 16 36 37 38 16 16 16 16 16 16 16 39 40 39 40 39 40 39 40 39 40 39 40 39 40 39 40 
0 0 34 14 14 14 14 14 14 14 14 14 14 14 14 14 4 5 34 21 18 21 19 41 20 21 18 21 18 21 18 22 0 8 34 23 23 23 23 23 23 23 23 23 23 23 23 23 0 8 34 23 23 23 23 23 23 23 23 23 23 23 23 23 4 5 34 21 18 21 19 41 20 21 18 21 18 21 18 22 0 0 34 14 14 14 14 14 14 14 14 14 14 14 14 14 4 5 34 21 18 21 19 41 20 21 18 21 18 21 18 22 40 39 40 39 40 39 40 39 40 39 40 39 40 39 39 42 
0 0 34 15 18 15 18 15 18 15 15 19 20 19 20 15 4 5 34 21 25 21 26 43 27 21 25 21 25 21 25 22 0 8 34 23 31 12 23 23 18 23 31 11 12 23 18 23 0 8 34 23 31 12 23 23 18 23 31 11 12 23 18 23 4 5 34 21 25 21 26 43 27 21 25 21 25 21 25 22 0 0 34 15 18 15 18 15 18 15 15 19 20 19 20 15 4 5 34 21 25 21 26 43 27 21 25 21 25 21 25 22 33 33 33 33 33 33 33 33 33 33 33 33 33 33 39 40 
0 0 34 15 25 15 25 15 24 15 15 26 27 26 27 15 4 6 34 21 30 21 26 43 27 21 30 21 30 21 30 22 2 8 34 23 17 17 23 23 30 23 19 41 20 23 30 23 2 8 34 23 17 17 23 23 30 23 19 41 20 23 30 23 4 6 34 21 30 21 26 43 27 21 30 21 30 21 30 22 0 0 34 15 25 15 25 15 24 15 15 26 27 26 27 15 4 6 34 21 30 21 26 43 27 21 30 21 30 21 30 22 44 45 44 45 44 45 44 45 44 45 44 45 44 45 39 42 
46 46 34 15 30 15 30 15 30 15 15 28 29 28 29 15 4 8 34 21 24 21 28 33 29 21 16 21 16 21 16 22 4 8 34 23 23 23 23 23 17 23 26 43 27 23 17 23 4 8 34 23 23 23 23 23 17 23 26 43 27 23 17 23 4 8 34 21 24 21 28 33 29 21 16 21 16 21 16 22 46 46 34 15 30 15 30 15 30 15 15 28 29 28 29 15 4 8 34 21 24 21 28 33 29 21 16 21 16 21 16 22 44 44 44 44 44 44 44 44 44 44 44 44 44 44 39 40 
44 44 34 15 14 15 14 15 14 15 15 14 14 14 14 15 4 8 34 47 47 47 48 49 50 47 47 47 47 47 47 47 4 8 34 47 47 47 47 47 47 47 28 33 29 47 47 47 4 8 34 47 47 47 47 47 47 47 28 33 29 47 47 47 4 8 34 47 47 47 48 49 50 47 47 47 47 47 47 47 44 44 34 15 14 15 14 15 14 15 15 14 14 14 14 15 4 8 34 47 47 47 48 49 50 47 47 47 47 47 47 47 44 44 44 44 44 45 44 45 44 45 44 45 44 45 39 42 
51 51 52 51 51 51 51 51 51 51 51 51 51 51 51 51 51 51 52 53 53 53 48 49 50 53 53 53 53 53 53 53 51 51 52 53 53 53 53 53 53 53 48 49 50 53 53 53 51 51 52 53 53 53 53 53 53 53 48 49 50 53 53 53 51 51 52 53 53 53 48 49 50 53 53 53 53 53 53 53 51 51 52 51 51 51 51 51 51 51 51 51 51 51 51 51 51 51 52 53 53 53 48 49 50 53 53 53 53 53 53 53 35 35 35 42 54 54 54 54 54 54 54 54 54 54 39 40 
55 55 55 55 55 56 57 58 57 58 59 55 55 55 55 55 55 55 55 55 55 55 55 55 55 55 55 55 55 55 55 55 55 55 55 55 55 55 55 55 55 55 55 55 55 55 55 55 55 55 55 55 55 55 55 55 55 55 55 55 55 55 55 55 55 55 55 55 55 55 55 55 55 55 55 55 55 55 55 55 55 55 55 55 55 56 57 58 57 58 59 55 55 55 55 55 55 55 55 55 55 55 55 55 55 55 55 55 55 55 55 55 39 40 39 40 60 35 42 35 35 35 35 35 35 35 39 40 
61 61 61 61 61 61 61 61 61 61 61 61 61 61 61 61 61 61 61 61 61 61 61 61 61 61 61 61 61 61 61 61 61 61 61 61 61 61 61 61 61 61 61 61 61 61 61 61 61 61 61 61 61 61 61 61 61 61 61 61 61 61 61 61 61 61 61 61 61 61 61 61 61 61 61 61 61 61 61 61 61 61 61 61 61 61 61 61 61 61 61 61 61 61 61 61 61 61 61 61 61 61 61 61 61 61 61 61 61 61 61 61 40 40 62 63 40 39 40 39 40 39 40 39 40 39 39 40 
61 61 61 61 61 61 61 61 61 61 61 61 61 61 61 61 61 61 61 61 61 61 61 61 61 61 61 61 61 61 61 61 61 61 61 61 61 61 61 61 61 61 61 61 61 61 61 61 61 61 61 61 61 61 61 61 61 61 61 61 61 61 61 61 61 61 61 61 61 61 61 61 61 61 61 61 61 61 61 61 61 61 61 61 61 61 61 61 61 61 61 61 61 61 61 61 61 61 61 61 61 61 61 61 61 61 61 61 61 61 61 61 39 40 39 40 39 40 39 40 39 40 39 40 39 40 40 39 