64
60
0 0 0 0 1 0 0 2 3 4 4 5 4 4 4 6 7 0 0 1 0 0 0 0 1 0 0 0 0 1 0 8 7 0 0 1 0 0 0 0 1 0 0 0 0 1 0 8 7 0 0 0 1 0 0 0 0 0 0 1 0 0 0 8
9 10 10 10 10 10 10 10 9 10 10 10 10 10 10 10 9 10 10 10 11 12 11 12 9 10 10 10 10 10 10 10 9 10 10 10 10 10 10 10 9 10 10 10 10 10 10 10 9 10 10 10 10 10 10 10 9 10 10 10 10 10 10 10
13 14 14 14 14 15 16 14 13 16 14 14 14 14 15 17 13 14 14 14 18 19 18 19 13 16 14 14 15 16 15 20 13 14 14 14 21 22 20 23 13 16 14 14 14 14 15 17 13 14 14 14 14 15 16 14 13 16 14 14 14 14 15 17
24 16 25 25 15 22 26 16 24 22 16 15 16 15 22 22 24 27 25 25 28 29 28 29 24 22 16 15 26 22 22 22 24 16 25 25 15 22 23 25 24 22 16 15 16 15 22 22 13 16 25 25 15 22 26 16 24 22 16 15 16 15 22 22
24 22 16 15 22 22 22 22 24 22 22 22 22 22 22 22 24 30 16 15 18 19 18 19 24 22 22 22 22 22 22 22 24 22 16 15 22 22 16 25 13 22 22 22 22 22 22 22 24 22 16 15 22 22 22 22 24 22 22 22 22 22 22 22
24 22 22 22 22 7 0 8 24 22 22 22 22 22 22 22 24 22 7 0 31 32 31 32 13 22 22 22 22 33 34 22 13 26 22 22 22 22 22 16 24 22 22 22 22 22 22 22 24 22 22 22 22 7 0 8 24 22 22 22 22 22 22 22
24 35 36 35 36 37 38 39 13 35 36 36 36 36 36 35 13 22 30 30 30 30 30 30 13 22 22 22 22 30 30 22 13 35 36 36 36 35 36 36 13 35 36 36 36 36 35 36 24 35 36 35 36 37 38 39 13 35 36 36 36 36 36 35
13 22 17 17 20 16 14 14 13 20 33 40 40 34 17 23 13 35 36 36 36 36 35 36 13 35 36 36 36 35 36 36 7 1 0 0 8 0 0 8 13 20 41 42 41 42 17 23 13 22 17 17 20 16 14 14 13 20 33 40 40 34 17 23
13 22 22 22 22 22 16 15 13 22 30 30 30 30 23 25 24 20 17 17 17 17 20 20 24 17 20 17 17 17 23 25 43 30 30 30 30 30 30 30 13 22 30 30 30 30 23 25 13 22 22 22 22 22 16 15 13 22 30 30 30 30 23 25
24 22 22 22 22 22 22 23 13 26 22 22 22 22 16 25 24 22 22 22 22 22 22 22 24 22 22 22 22 22 16 25 24 22 22 44 45 22 22 23 13 22 22 22 22 22 16 25 24 22 22 22 22 22 22 23 13 26 22 22 22 22 16 25
9 22 22 22 22 22 22 16 24 22 22 22 22 22 22 16 11 12 11 12 22 22 22 11 12 22 22 11 12 22 22 16 9 22 22 46 47 22 22 16 9 22 22 22 22 22 22 16 9 22 22 22 22 22 22 16 24 22 22 22 22 22 22 16
9 35 36 36 36 36 35 36 13 36 36 36 36 36 35 36 18 19 18 19 35 35 35 18 19 35 36 18 19 35 36 36 9 35 36 48 49 36 35 36 9 35 36 35 36 36 35 36 9 35 36 36 36 36 35 36 13 36 36 36 36 36 35 36
7 1 0 8 17 17 22 20 13 17 20 17 22 7 1 8 31 32 31 32 0 0 0 31 32 0 0 31 32 0 0 8 7 0 50 0 0 50 0 0 1 0 0 0 1 0 0 8 7 1 0 8 17 17 22 20 13 17 20 17 22 7 1 8
51 52 52 53 41 42 22 22 9 22 22 41 42 51 52 53 51 52 52 52 52 52 52 52 52 52 52 52 52 52 52 53 51 52 52 52 52 52 52 52 52 52 52 52 52 52 52 53 51 52 52 53 41 42 22 22 9 22 22 41 42 51 52 53
37 38 38 39 30 30 22 22 9 22 22 30 30 37 38 39 37 38 38 38 38 38 38 38 38 38 38 38 38 38 38 39 37 38 38 38 38 38 38 38 38 38 38 38 38 38 38 39 37 38 38 39 30 30 22 22 9 22 22 30 30 37 38 39
9 54 54 54 54 54 54 54 9 54 54 54 54 54 54 54 7 0 0 1 0 0 0 0 1 0 0 0 0 1 0 8 9 54 54 54 54 54 54 54 9 54 54 54 54 54 54 54 9 54 54 54 54 54 54 54 9 54 54 54 54 54 54 54
9 10 10 10 10 10 10 10 9 10 10 10 10 10 10 10 51 52 52 52 52 52 52 52 52 52 52 52 52 52 52 55 9 10 10 10 10 10 10 10 9 10 10 10 10 10 10 10 9 10 10 10 10 10 10 10 9 10 10 10 10 10 10 10
13 14 14 14 14 14 14 14 13 16 14 14 14 14 15 22 56 57 57 57 57 57 57 57 57 57 57 57 57 57 57 58 13 14 14 14 14 14 14 14 13 16 14 14 14 14 15 22 13 15 16 14 14 14 14 14 13 16 14 14 14 14 15 20
13 16 25 25 15 16 25 25 13 22 16 15 16 15 22 22 56 57 57 57 57 57 57 57 57 57 57 57 57 57 57 58 13 16 25 25 15 16 25 25 13 22 16 15 16 15 22 22 24 22 22 16 15 16 25 25 24 22 16 15 16 15 22 22
24 22 16 15 22 22 16 25 24 22 22 22 22 22 22 22 51 52 52 52 52 52 52 52 52 52 52 52 52 52 52 53 24 22 16 15 22 22 16 25 24 22 22 22 22 22 22 22 24 22 22 22 22 22 41 42 41 42 22 22 22 22 22 22
24 22 22 22 22 22 22 59 60 61 22 22 22 22 22 22 56 57 57 57 57 57 57 57 57 57 57 57 57 57 57 58 24 22 22 22 22 22 22 16 13 22 22 22 22 22 22 22 13 22 22 22 22 22 30 30 43 30 22 22 22 22 26 22
24 36 36 36 35 36 36 62 63 64 36 36 36 36 35 36 56 57 57 57 57 57 57 57 57 57 57 57 57 57 57 58 24 36 36 36 35 36 36 36 13 36 36 36 36 36 35 36 13 35 36 36 35 36 35 36 24 35 35 36 36 35 36 35
13 22 17 17 22 22 17 16 13 22 17 20 22 17 22 23 56 57 57 57 57 57 57 57 57 57 57 57 57 57 57 58 13 22 17 17 22 22 17 16 13 22 17 20 22 17 22 23 13 65 66 67 17 20 17 16 24 20 17 20 65 66 67 17
13 22 22 22 22 22 22 22 13 22 22 22 22 22 23 25 56 57 57 57 57 57 57 57 57 57 57 57 57 57 57 58 13 22 22 22 22 22 22 22 13 22 22 22 22 22 23 25 13 30 30 30 22 33 34 22 24 33 34 22 30 30 30 22
24 22 22 22 22 22 22 23 24 22 22 22 22 22 16 25 56 57 57 57 57 57 57 57 57 57 57 57 57 57 57 58 24 22 22 22 22 22 22 23 24 22 22 22 22 22 16 25 24 22 22 22 22 30 30 22 13 30 30 22 22 22 22 22
13 22 22 22 22 22 22 16 24 22 22 22 22 22 22 16 51 52 52 52 52 52 52 52 52 52 52 52 52 52 52 53 13 22 22 22 22 22 22 16 24 22 22 22 22 22 22 16 9 22 22 22 22 22 22 22 24 22 22 22 22 22 22 22
13 35 36 36 36 35 36 36 13 36 36 36 36 35 36 36 56 57 57 57 57 57 57 57 57 57 57 57 57 57 57 58 13 35 36 36 36 35 36 36 13 36 36 68 69 70 36 36 9 36 36 36 36 36 36 36 9 36 36 36 36 36 36 35
24 15 17 22 20 22 22 22 13 20 17 22 22 22 22 16 56 57 57 57 57 57 57 57 57 57 57 57 57 57 57 58 24 15 17 22 20 22 22 22 13 20 17 71 72 73 22 16 7 74 75 75 75 75 75 75 75 75 75 75 75 75 76 8
9 22 22 22 22 22 22 22 9 22 22 22 22 22 22 22 56 57 57 57 57 57 57 57 57 57 57 57 57 57 57 58 9 22 22 22 22 22 22 22 9 22 22 22 22 22 22 22 51 52 52 52 53 52 52 52 52 51 52 52 52 52 52 53
9 22 22 22 22 22 22 22 9 22 22 22 22 22 22 22 37 38 38 38 38 38 38 38 38 38 38 38 38 38 38 39 9 22 22 22 22 22 22 22 9 22 22 22 22 22 22 22 37 38 38 38 39 38 38 38 38 37 38 38 38 38 38 39
7 0 0 1 54 54 54 54 9 54 54 54 54 54 54 54 9 54 54 54 54 54 54 54 9 54 54 54 54 54 54 54 9 54 54 54 54 54 54 54 9 54 54 54 54 54 54 54 9 54 54 54 54 54 54 54 9 54 54 54 54 54 54 54
51 52 52 53 10 10 10 10 9 10 10 10 10 10 10 10 9 10 10 10 10 10 10 10 9 10 10 10 10 10 10 10 9 10 10 10 10 10 10 10 9 10 10 10 10 10 10 10 9 10 10 10 10 10 10 10 9 10 10 10 10 10 10 10
56 57 57 58 14 14 14 14 13 16 14 14 14 21 22 20 13 14 14 14 14 14 14 14 13 16 14 14 14 14 15 22 13 14 14 14 14 14 14 14 13 16 14 14 14 14 15 22 13 14 14 14 14 14 14 14 13 14 15 16 14 14 15 20
56 57 57 58 33 40 40 40 40 34 16 15 16 15 26 77 24 16 25 25 15 16 25 15 24 22 16 15 16 15 22 22 13 16 25 25 15 16 25 25 13 22 16 15 16 15 22 22 24 16 25 25 15 16 25 25 24 15 22 22 16 15 22 22
51 52 52 53 30 30 30 30 43 30 22 22 22 22 22 78 24 22 16 15 22 41 42 22 24 22 22 22 22 22 22 22 24 22 16 15 22 22 16 79 80 81 22 22 22 22 22 22 24 22 16 15 22 22 16 15 24 22 22 22 22 26 22 22
56 57 57 58 22 22 22 23 13 22 22 22 22 22 7 8 13 22 22 22 22 30 30 22 13 36 7 8 35 36 36 36 24 22 22 22 22 22 22 16 82 73 22 22 22 22 22 22 24 35 7 8 35 36 36 7 8 35 36 35 7 8 35 36
56 57 57 58 35 36 23 25 13 35 36 35 36 35 51 53 9 20 17 20 17 17 20 17 24 20 51 53 17 20 20 17 24 36 36 36 35 36 36 36 13 36 36 36 36 36 35 36 13 17 51 53 20 17 20 51 53 17 20 17 51 53 17 20
37 38 38 39 20 22 17 20 13 20 33 40 40 34 37 39 7 0 8 35 35 35 35 35 24 35 37 38 7 0 0 8 13 22 17 17 22 22 17 16 13 22 17 20 22 17 22 23 7 1 37 39 7 0 8 37 39 7 0 8 37 39 0 8
43 30 30 30 22 33 34 22 24 22 30 30 30 30 30 30 51 52 53 17 20 17 20 23 13 17 30 30 30 30 30 30 13 22 22 22 22 22 22 22 13 22 22 22 22 22 23 25 43 30 30 30 30 30 30 30 43 30 30 30 30 30 30 30
13 22 83 22 22 30 30 23 24 22 22 22 22 22 22 23 56 57 58 35 23 21 23 84 24 21 35 35 36 35 36 35 24 22 22 22 22 22 22 23 24 22 22 22 22 22 16 25 24 22 22 44 45 22 22 23 24 21 23 21 22 22 22 22
24 22 85 22 22 22 22 16 13 22 22 22 22 22 23 25 56 57 58 23 25 25 84 86 24 15 17 20 22 26 17 23 13 22 22 22 22 22 22 87 80 81 22 22 22 22 22 16 9 22 22 46 47 22 22 16 9 25 25 25 21 26 22 22
13 35 36 36 35 35 36 36 13 35 35 36 35 23 25 25 56 57 58 25 25 84 86 86 9 35 36 35 35 35 23 84 13 35 36 36 36 35 36 88 82 89 36 36 36 35 36 36 9 35 36 48 49 36 35 36 9 25 25 25 25 21 36 35
7 8 20 17 20 17 22 20 24 20 17 22 20 17 20 7 56 57 58 7 0 1 0 90 91 0 1 0 0 90 91 8 24 15 17 22 20 22 22 22 13 20 17 22 22 22 22 16 7 0 50 0 0 50 0 0 1 0 0 0 0 1 0 8
51 52 7 8 22 22 22 22 9 22 22 22 22 7 8 53 51 52 52 52 52 52 52 52 52 52 52 52 52 52 52 53 9 22 22 22 22 22 22 22 9 22 22 22 22 22 22 22 51 52 52 52 52 52 52 52 52 52 52 52 52 52 52 53
37 38 38 39 22 22 22 22 9 22 22 22 22 37 38 39 37 38 38 38 38 38 38 38 38 38 38 38 38 38 38 39 9 22 22 22 22 22 22 22 9 22 22 22 22 22 22 22 37 38 38 38 38 38 38 38 38 38 38 38 38 38 38 39
9 54 54 54 54 54 54 54 9 54 54 54 54 54 54 54 7 0 0 0 0 0 0 0 0 0 0 0 0 0 0 8 9 54 54 54 54 54 54 54 9 54 54 54 54 54 54 54 7 0 0 1 0 0 51 52 52 52 53 0 1 0 0 8
9 14 14 21 20 26 23 14 9 14 14 14 14 14 14 15 51 52 52 52 52 52 52 52 52 52 52 52 52 52 52 53 9 10 10 10 10 10 10 10 9 10 10 10 10 10 10 10 9 10 10 10 10 10 51 52 52 52 53 10 10 10 92 93
13 94 25 25 21 23 25 25 13 16 25 25 25 25 15 22 37 38 38 38 38 38 38 38 38 38 38 38 38 38 38 39 13 15 16 95 14 14 14 14 24 16 14 14 14 14 15 20 24 14 14 14 14 14 51 52 52 52 53 14 14 14 93 96
24 16 25 25 15 16 25 25 13 22 16 15 16 15 22 22 56 57 57 57 57 58 14 14 14 14 56 57 57 57 57 58 13 26 22 97 15 16 25 25 24 22 16 15 16 15 22 22 13 16 25 25 15 16 51 52 52 52 53 15 16 15 92 98
13 22 16 15 22 22 16 25 24 22 22 22 22 22 22 22 56 57 57 57 57 58 16 25 15 16 56 57 57 57 57 58 13 22 22 22 22 22 7 0 0 0 8 22 22 22 22 22 13 22 16 15 22 22 51 52 52 52 53 22 22 22 93 96
13 22 22 22 22 22 22 16 13 22 22 22 22 22 22 22 56 57 57 57 57 58 33 40 40 34 56 57 57 57 57 58 7 0 0 8 22 22 37 38 38 38 39 22 22 22 22 22 24 36 35 36 36 35 51 52 52 52 53 35 35 36 92 93
13 35 36 36 36 35 36 36 13 36 36 35 36 35 35 36 56 57 57 57 57 58 30 30 30 30 56 57 57 57 57 58 51 52 52 53 22 22 30 30 43 30 30 22 22 22 22 22 13 35 7 8 35 36 51 52 52 52 53 36 36 35 93 96
24 22 17 20 17 17 20 16 13 22 22 17 20 17 17 23 37 38 38 38 38 39 22 22 26 22 37 38 38 38 38 39 37 38 38 39 35 36 36 35 13 35 36 36 35 7 0 8 24 20 51 53 17 20 51 52 52 52 53 20 17 17 92 98
24 22 22 22 22 22 22 22 13 22 22 22 22 22 23 25 43 14 14 14 14 14 21 22 22 22 30 30 30 30 30 30 43 30 30 30 17 17 17 16 24 17 22 22 17 30 30 30 24 22 51 53 22 22 37 38 38 38 39 22 22 23 93 96
13 22 22 22 22 22 22 23 24 22 22 22 22 22 16 25 24 25 25 25 25 25 15 77 23 21 22 22 22 22 22 22 24 22 22 22 22 22 22 22 13 22 22 22 22 22 22 23 24 22 51 53 22 22 99 30 43 100 14 21 23 84 101 102
9 22 22 22 22 22 22 16 9 22 22 22 22 26 22 16 9 25 25 25 25 15 22 103 25 25 21 22 22 22 22 23 9 22 22 22 22 22 22 22 9 22 26 22 22 22 23 25 9 22 51 53 22 104 105 22 9 106 25 25 84 86 107 108
9 36 36 35 36 35 36 36 9 35 36 36 36 35 36 36 9 25 25 25 25 21 23 109 25 25 25 21 35 36 23 25 9 35 35 36 36 35 36 35 9 35 36 36 36 23 25 25 9 35 51 53 35 36 110 35 9 111 25 84 86 86 107 108
7 0 0 1 0 0 0 0 1 0 0 90 91 1 0 8 7 0 0 0 0 0 0 0 0 0 0 0 0 0 0 8 7 0 0 0 0 0 0 0 0 0 0 90 91 0 0 8 7 0 51 53 0 1 50 50 50 50 50 0 0 0 0 8
51 52 52 52 52 52 52 52 52 52 52 52 52 52 52 53 51 52 52 52 52 52 52 52 52 52 52 52 52 52 52 53 51 52 52 52 52 52 52 52 52 52 52 52 52 52 52 53 51 52 52 52 52 52 52 53 52 52 52 52 52 52 52 53
112 113 113 113 113 113 113 113 113 113 113 113 113 113 113 114 112 113 113 113 113 113 113 113 113 113 113 113 113 113 113 114 112 113 113 113 113 113 113 113 113 113 113 113 113 113 113 114 112 113 113 113 113 113 113 114 113 113 113 113 113 113 113 114